  ***
 *****
*** ***
*******
*******
 *****
  ***